%%%%%%%%%%%%%%%%%%%%%%%%%%%%%%%%%%%%%%%%%%%%%%%%%
%G                        %                    %
%            %   %% % %%% %        %            %
%         %%%                 %          %%%%   %           
%       %%                   %%%      %     %  %%
%   %%%%                 %%      %%%    %%%   %%%
%              %%% %%              %        %%%%%
%   %   %%%                 %          %%%%   %%%
% %     %  %   % %    %      %%%%  %% % %%%% %%%%
%         %    %%%   %%% %%%%  %%       % %%   %%
%            %            %%%%      %%  %%   %  %
%%%%  %  %   %%%          %     %   %     g   % %
%    %%%%%%%%%%%       %%   %    %%%%%%%%%%%    %
%   %%    %     %%     %%            %     %%% %%
%            %             %   %     %    %     %
%    %%%   %      %%      %     %%%     %       %
%            %             %                    %
%%%% %      %  %   % %    %   %           %     %
%                          %%%  %%%  %%  %%%%% %%
%                          %%    %         %%   %  
%   % %      %  %   % %    %   %  %   %         %
%                          %   %       %%   %% %%
% %%     %  %   % %    %     %    %             %
%                          %%%%% %% %%%%%   %%%%%
%   %  %    %  %     % %    %  % %  %     %     %
%G    %  %%%  %  %%%   %  %%%             %    P%
%%%%%%%%%%%%%%%%%%%%%%%%%%%%%%%%%%%%%%%%%%%%%%%%%
