%%%%%%%%%%%%%%%%%%%%
%o...%..%P.o..%....%
%.%%.%.%%%%%%.%.%%.%
%.%..............%.%
%.%.%%.%%  %%.%%.%.%
%......%    %......%
%.%.%%.%%%%%%.%%.%.%
%.%....... ......%.%
%.%%.%.%%%%%%.%.%%.%
%.G..%.......%...oG%
%%%%%%%%%%%%%%%%%%%%
