%%%%%%%%%%%%%%%%%%%%%%%%%
%   P                   %
%                       %
%                       %
%                       %
%                       %
%..  ...  ...  ...  ... %
%..    ....      ....   %
%%%%%%%%%%%%%%%%%%%%%%%%%
