%%%%%%%%%%%%%%%%%%%%%%%%%%%%
%G                        G%
%                          %
%                          %
%                          %
%                          %
%                          %
%                          %
%            %             %
%            %             %
%            %             %
%            %             %
%       %%%%%%%%%%%        %
%            %             %
%            %             %
%            %             %
%            %             %
%                          %
%                          %
%                          %
%                          %
%                          %
%                          %
%                          %
%                          %
%G                        P%
%%%%%%%%%%%%%%%%%%%%%%%%%%%%
