%%%%%%%%%%%%%%%%%%%%%%%%%%%%%%%%%%
%G                              G%
%                    %%          %
%     %%             %%          %
%     %%                   %%    %
%                          %%    %
%              %%                %
%              %%                %
%       %%     %%       %%       %
%       %%     %%       %%       %
%              %%                %
%  %%          %%             %% %
%  %%   %%%%%%%%%%%%%%%%      %% %
%       %%%%%%%%%%%%%%%%         %
%              %%            %%  %
%              %%            %%  %
%              %%                %
%    %%        %%                %
%    %%        %%                %
%              %%                %
%                   %%           %
%                   %%           %
%     %%                         %
%     %%       %%          %%    %
%              %%          %%    %
%G                              P%
%%%%%%%%%%%%%%%%%%%%%%%%%%%%%%%%%%
